################
#..............#
#........*.....#
#..............#
#...@.........%#
#..............#
#..............#
#........&.....#
#............###
#..........##$$$
############$$$$