################
#..............#
#...........&..#
#..............#
#...@..........#
#..............#
#..............#
#.......&.....##
#.............##
#.............##
################
